S 0 0 0 0 0 0 0 0 0 0 0 0 0 0
0 # # 0 0 0 0 # 0 0 0 0 0 0 0
0 0 0 0 2 2 0 # 0 0 0 3 0 0 0
0 0 0 0 0 0 0 # 0 # # # 0 0 0
0 0 3 3 3 0 0 0 0 0 0 0 0 0 0
0 0 0 0 0 0 0 0 # 0 0 0 0 0 0
0 0 0 0 0 M 0 0 # 0 0 0 0 0 0
0 0 # 0 0 0 0 0 # 0 0 # # 0 0
0 0 # 0 0 0 0 0 # 0 0 0 0 0 0
0 0 # 0 0 0 0 0 # 0 0 0 0 0 0
0 0 # 0 0 0 0 0 # 0 0 0 0 0 0
0 0 # 0 0 0 0 0 # 0 0 0 0 0 0
0 0 # 0 0 0 0 0 # 0 0 0 0 0 0
0 0 0 0 0 0 0 0 0 0 0 0 0 0 G
0 0 0 0 0 0 0 0 0 0 0 0 0 0 0
